%%%%%%%%%%%%%%%%%%%%%%%%%%%%%%%%%%%%%%%%%%%%%%%%%%%%%%%%%%%%%%%%%%%%%%%%%%%%%%%%
%.                                                                             %
%                                                                             .%
%.                                                                             %
%                                                                             .%
%.                                                                             %
%                                                                             .%
%.                                                                             %
%                                                                             .%
%.                                                                             %
%                                                                             .%
%.                                                                             %
%                                                                             .%
%.                                                                             %
%                                                                             .%
%.                                                                             %
%                                                                             .%
%.                                                                             %
%                                                                             .%
%.                                                                             %
%                                                                             .%
%.                                                                             %
%                                                                             .%
%.                                                                             %
%                                                                             .%
%.                                                                             %
%                                                                             .%
%.                                                                             %
%                                                                             .%
%.                                                                             %
%                                                                             .%
%.                                                                             %
%                                                                             .%
%.                                                                             %
%                                                                             .%
%.                                                                             %
%                                                                             .%
%.                                                                             %
%                                                                             .%
%.                                                                             %
%                                                                             .%
%.                                                                             %
%                                                                             .%
%.                                                                             %
%                                                                             .%
%.                                                                             %
%                                                                             .%
%.                                                                             %
%                                                                             .%
%.                                                                             %
%                                                                             .%
%.                                                                             %
%                                                                             .%
%.                                                                             %
%                                                                             .%
%.                                                                             %
%                                                                             .%
%.                                                                             %
%                                                                             .%
%.                                                                             %
%                                                                             .%
%.                                                                             %
%                                                                             .%
%                                                                              %
%                                                                              %
%                                                                              %
%                                                                              %
%                                                                              %
%                                                                              %
%                                                                              %
%                                                                              %
%                                                                              %
%                                                                              %
%                                                                              %
%                                                                              %
%                                                                              %
%                                                                              %
%                                                                              %
%                                                                              %
%                                                                              %
%                                                                              %
%                                                                              %
%                                                                              %
%                                                                              %
%                                                                              %
%                                                                              %
%                                                                              %
%                                                                              %
%                                                                              %
%                                                                              %
%                                                                              %
%                                                                              %
%                                                                              %
%                                                                             P%
%%%%%%%%%%%%%%%%%%%%%%%%%%%%%%%%%%%%%%%%%%%%%%%%%%%%%%%%%%%%%%%%%%%%%%%%%%%%%% %
%                                                                              %
%                                                                              %
%                                                                              %
%                                                                              %
%                                                                              %
%                                                                              %
%                                                                              %
%                                                                              %
%                                                                              %
%                                                                              %
%                                                                              %
%                                                                              %
%                                                                              %
%                                                                              %
%                                                                              %
%                                                                             .%
%%%%%%%%%%%%%%%%%%%%%%%%%%%%%%%%%%%%%%%%%%%%%%%%%%%%%%%%%%%%%%%%%%%%%%%%%%%%%%%%
