%%%%%%%%%%%
%        P%
%  %      %
%  %      %
%  %  %   %
%  %  %   %
%%%%  %%%%%
%  %      %
%  %      %
%         %
%.        %
%%%%%%%%%%%